PPPPPPPPPPPPPPPPP
PPPPPPPPPFFMMPPFF
PPPPPPPPPFFMMPPFF
PPPPEEMPPPPPPPPPP
PPEEVVEEPPPPPPPPP
PPFFMMVVPPPPPPPPP
PPFFMMVVPPPPPPPPP
PPPPPPPPPPPPPPPPP
