PPPPPPPPPPPPPPPPPPPPPPPPPPPPP
PPPPPPPPPPPPPPEEEEPPPPPPPPPPP
PPPPPPPPPPPFFEEMMFFFFPPPPPPPP
PPPFFFFFPPPFFEEMMFFFFPPPPPPPP
PPPFFFFFPPPFFFFMMMMMMPPPPPPPP
PPPFFFFFPPPFFFMVVVVMMMPPTPPPP
PPPFFFFFPPPFFFMMMMMMMPPPPPPPP
PPPFFVVVFFEEEEMMMMPPPPCCPPPPP
PPPPVVVVFEEEEMVMPPCCCCCCCPPPP
PPPPPPPPFEMMMMMPPCCCCCCCPPPPP
PPPFFVEEEMMMMMPPPPPPCCPPPPPPP
PPVVFEEEEMMMMPPPPPPPPPPPPPPPP
FFFFPPPFFFMMMMPPPTPPPPPPPPPPP
PPPFFFFFPPPFFFMMMPPPTTPPPPPPP
PPPPPPPPPPPFFFFPPPTTPPPPPPPPP
PPPPPPPPPPPPPPPPPPPPPPPPPPPPP
PPPPPPPPPPPPPPPPPPPPPPPPPPPPP
PPPPPPPPPPPPPEEEEPPPPPPPPPPPP
PPPPPPPPPPPFEEMMFFFFPPPPPPPPP
PPPFFFFFPPFFEEMMFFFFPPPPPPPPP
PPPFFFFFPPFFFFMMMMMMPPPPPPPPP
PPPFFFFFPPFFFMVVVVMMMPPPTPPPP
PPPFFFFPPPFFFMMMMMMMPPPPPPPPP
PPPFFVVFFEEEEMMMMPPPPPCCPPPPP
PPPPVVVFEEEEMVMPPCCCCCCCCPPPP
PPPPPPPFEMMMMMPPCCCCCCCCPPPPP
PPPFVEEEMMMMMPPPPPPPCCPPPPPPP
PPVFEEEEMMMMPPPPPPPPPPPPPPPPP
FFFPPPFFFMMMMPPPTTPPPPPPPPPPP
PPFFFFFPPPFFFMMMMPPPTTPPPPPPP
PPPPPPPPPPPFFFFPPPPTTPPPPPPPP
PPPPPPPPPPPPPPPPPPPPPPPPPPPPP