PPPPPPPPPPPPPPPPPPPPPPPPPPPPPPP
PPPPPPPPPPPPPPPPPPPPPPPPPPPPPPP
PPPPPPPPPPPPEEEEPPPPPPPPPPPPPPP
PPPPPPPPPFFEEMMFFFFPPPPPPPPPPPP
PPPFFFFFPFFEEMMFFFFPPPPPPPPPPPP
PPPFFFFFPPFFFMMMMMMPPPPPPPPPPPP
PPPFFFFFPPFFMVVVVMMMPPPTPPPPPPP
PPPFFFFFPPPFMMMMMMMPPPPPPPPPPPP
PPPFFVVVFFEEEMMMPPPPPCCPPPPPPPP
PPPPVVVVFEEEEVPPCCCCCCCCPPPPPPP
PPPPPPPPFEMMMMPCCCCCCCCPPPPPPPP
PPPFFVEEEMMMMMPPPPPCCPPPPPPPPPP
PPVVFEEEEMMMMPPPPPPPPPPPPPPPPPP
FFFFPPPFFFMMMMPPPTPPPPPPPPPPPPP
PPPFFFFFPPPFFFMMMMPTTPPPPPPPPPP
PPPPPPPPPPPFFFFPPPPTPPPPPPPPPPP
PPPFFFFFPPPFFFMMMMMMPPPPPPPPPPP
PPPFFVVVFFEEEEMMMMPPPPCPPPPPPPP
PPPPVVVVFEEEEMVMPPCCCCCCPPPPPPP
PPPPPPPPFEMMMMMPPCCCCCCCPPPPPPP
PPPFFVEEEMMMMMPPPPPPPCCPPPPPPPP
PPVVFEEEEMMMMPPPPPPPPPPPPPPPPPP
FFFFPPPFFFMMMMPPPTTPPPPPPPPPPPP
PPPFFFFFPPPFFFMMMMPPPTTPPPPPPPP
PPPPPPPPPPPFFFFPPPPTTPPPPPPPPPP
PPPPPPPPPPPPPPPPPPPPPPPPPPPPPPP
PPPPPPPPPPPPPPPPPPPPPPPPPPPPPPP