FFFFFFFVFFFFFFFJFPFJFJFFFFFJFFFFFFFFWHHM
FFFFFFFVFJFFFFFJJPJJJJFJFFFJFJFJFJFWWHHM
FFFFFFFJJJJJJJJJRRPJJJJJJJJJJDDDJJJWJVHH
WWWWFFFJJRRJJJJJRDPPJJJJJJJDDDDDJJJWJDHH
WWBWVJFJJRRDDDDDDJDPJJJJJPJJDJVJJDJDXJJJ
WWBWJJJJRRRJDJDDDJJJPPPPPJPPJDDDDJDJWJJJ
WWBBWWWWSDJJJDDDJDJJJJJJJJJJPJJJJJJWWJJJ
WWBWWJWJWWDWJDDDDRJFJJJJJJJPPJJJJJJWJJDJ
JJWSJVJJJJWJWWJDCRFFFJJJJPPPJJJDDDJJWWJJ
JWWWJJJFJJJJJJWJRJFJFFFJJPJJPJDDDDDJJWJJ
WWWWWFFFJJJJJJWWJJJJJJJJJPJJPJJJDWDDVWJJ
WWWWWFFDFJJFJJXWWWWWJWBBPWWWPWWWWWWWWGGG
WWWWGVDDDJJDJDJDWWWWWWWWPWWWWWWWWWWGGGGG
WGWGGDDFDDDDDJDGGGBWWWWWWWWWWWWGPGGGGGGG
GGWWDJFFFDDGJJGJJGBBBGWGPPGGGGGGPPGPGGGG
GGGWDJFJFJJJJFJJJJJJGGGGFGPGFFFGGGPGPGGG
GGGWDFJJJJJHJJFJFGGGGGGFFGPGFFGGGGGGPGGP
GGWDDFFFGGJHJJJJFJHJJFHFGGPGFGGGGGGGPPPG
DDWWFGFFJFHHJJJJFFGFFGFGGGPPGGGGGGGVGGGG
GGGWGGJJJFJFFFGGGGFFGGFGGGGPGGGGGVGGGGGG
HHGWGVVVGGFGFFGFGFFHFFHGGGGPGGGFFGGGGGGG
GGWWHRVVVGGFGGGFHHGGGGHFGGGPGPFFFGGGGGGG
HHHWHRFFFFFFFFFHHHGGGHFGFGGGPGPGGGGGGGGG
HHGWGGRGFHFGFGGHGHHHGBHGGGGGGGPPGGGGGGGG
HMWMHHGGHHGGGGHGHWHWBHHHGGGGGGGGPPGGGGGG
MMWWMMGHHMGGGGGWWEWWBBHHGHGGGGGGGGPGGGGG
MMMMWMHHMMHMHHHHWWWBBVBMHHGHHGGGGGPPGGGG
MMMWWMMMMMMMMMHWWWWHBHBMMHHHHHGGGVVVPPGG
MWWWMMMMMMMMMWMWWXHHHMMMHHHHHHHMGHVVVPGG
WWOOWMMMMMMOOWWMWMHMHMMMHMHMMMMMHHGGGPGG
WWOOWWMMMMMOOMMMMMMMMMMMMMMMMMMMMHHHHGPG
OOOOOOWEMOOOOMMMMMMMMMMMMMMMMMMMMHHHHGPG
WWWWWWWWWWWWMMMMMMMMMMMMMMMMMMMMMHHHGHPM