PPPPPPPPPPPPPPPPPPPPPPPPPPPPPP
PPPPPPPPPPPPPPPPPPPPPPPPPPPPPP
PPPPPPPPPPPPPEEEEPPPPPPPPPPPPP
PPPPPPPPPPFFEEMMFFFFPPPPPPPPPP
PPPFFFFFPPFFEEMMFFFFPPPPPPPPPP
PPPFFFFFPPFFFFMMMMMMPPPPPPPPPP
PPPFFFFFPPFFFMVVVVMMMPPPTPPPPP
PPPFFFFFPPPFFMMMMMMMPPPPPPPPPP
PPPFFVVVFFEEEMMMMPPPPPCCPPPPPP
PPPPVVVVFEEEEVMPPCCCCCCCCPPPPP
PPPPPPPPFEMMMMPPCCCCCCCCPPPPPP
PPPFFVEEEMMMMMPPPPPPCCPPPPPPPP
PPVVFEEEEMMMMPPPPPPPPPPPPPPPPP
FFFFPPPFFFMMMMPPPTPPPPPPPPPPPP
PPPFFFFFPPPFFFMMMMPPTTPPPPPPPP
PPPPPPPPPPPFFFFPPPPTPPPPPPPPPP
PPPFFFFFPPPFFFMMMMMMPPPPPPPPPP
PPPFFVVVFFEEEEMMMMPPPPCCPPPPPP
PPPPVVVVFEEEEMVMPPCCCCCCCPPPPP
PPPPPPPPFEMMMMMPPCCCCCCCPPPPPP
PPPFFVEEEMMMMMPPPPPPPCCPPPPPPP
PPVVFEEEEMMMMPPPPPPPPPPPPPPPPP
FFFFPPPFFFMMMMPPPTTPPPPPPPPPPP
PPPFFFFFPPPFFFMMMMPPPTTPPPPPPP
PPPPPPPPPPPFFFFPPPPTTPPPPPPPPP
PPPPPPPPPPPPPPPPPPPPPPPPPPPPPP
PPPPPPPPPPPPPPPPPPPPPPPPPPPPPP