FFFFFFVFFFFFFFGGPGGGFFFFFGFFFFFFFFFFWHHM
FFFFFFFJJJJYJYJJRPPJJJYYJYJJJJDJJJJWJHHM
WFWFFFFJJJRYYYYYRRPJJJYJJJJJDDDDJJJWJJHH
WWBWJFFJJRRJDJDJDDDPJJJJJJJDDDJDJJJWXDJH
WWBOGJJJR?RDDDDDDYJPPJPJPPPJJJDJDDDDWJJJ
WWBOOJWGSRJYYYDDYYJJJPJPJJJPPDJDJJJJWJJJ
WWBBWWWWWDDJGDDDDDGJJJJJJGJJPJJJJJJWJJDJ
GWWWGJJGGWWWWDJDCRFFFJJGGGPPJJJJDJJWWJJJ
GGWSGGJGGGGGGWWDRRFFFJFJJPJPPJDDDDDJJWJJ
WWOWWGFFGJJGGGWGJJGJJFJJGPJJPJJDDDDJJWAA
WWOOWFFFFJJGJGXWWGWGJJBJPPWGPGWGWWWDWWGG
WWWWGFDDDJJFJJJWWWWWWWWBPWWWOWOWWWWWGGGG
WWWWGDDDDJDDDDDDGWBWOOOWWWOOWOWWGWGGGGJJ
GGWGDDFFFDDDJJGGJGBOBWWWPWGWGWGPPGGGGGJJ
GGGWDJFFFDJGGJJJJGJBGGGGFPPGFGFGGPPPPJJJ
GGGWDJJJJJGGJFFJFJGJGGGGFGPGFFGGGGGGPJGG
GGWWDFFJGJJHJJGJFGHGJGHFGGPGFFGGGJGGPGPP
DGWDFFFFJGHHJJJJFJGGFFFFGGPGGGGGGGGGGPJG
GDGWGGJFJFJHFJGJJFFFJGFGGGGPGGGGGGGDGGJG
HGGWGGGJJFFFFFGGGGFFFGHGGHGPGGDJVVGGGJGG
GHWWHGGGJJJJJFJFHFJHGFHGGGGPGDDV?JVGGGGG
HGHWHRGGGGFFFJFFHHJJGGFFFGGPPPPVVVVGGGGG
HHGWGRRFFFFFFGGHJHHJGHHGGGGGGGPGGVGGGGJG
HHWWHGGGHHGGGJHHHHHHBBHGGHHGGGGPPGGGGGJJ
MMWMMHGGHHGGGGGGWWWWBHHHGGGGGGGGGPPGGJJJ
MMMWWMHHMMHGHGHAWEWWBBBHHHGGHGGGGGPGGJJJ
MMMMWMMHMMMMMHHHWWWBBHBMMHHHHGGGGGGPPGGJ
MMWWMMMMMMMMMMMWOOHHHHMMHHHHHHHGGGGGGPGG
WWOWWMMMMMMMOWWWWXHHHMMMHHHHMHMMHHJGGPGG
WWOOWMMMMMMOOWMMMMMMMMMMMMMMMMMMMHHJHPPG
OWOOOWWMMMOOOMMMMMMMMMMMMMMMMMMMMHHHHJPG
OOOOOOWEEOEOMMMMMMMMMMMMMMMMMMMMMHHHJJPG
