PPPPPPPPPPPPPPPPPPPPPPPPPPPPP
PPPPPPPPPPPPPEEEEPPPPPPPPPPPP
PPPPPPPPPPFFEEMMFFFFPPPPPPPPP
PPPFFFFFPPFFEEMMFFFFPPPPPPPPP
PPPFFFFFPPFFFFMMMMMMPPPPPPPPP
PPPFFFFFPPFFFMVVVVMMMPPPTPPPP
PPPFFFFFPPPFFMMMMMMMPPPPPPPPP
PPPFFVVVFFEEEMMMMPPPPPCCPPPPP
PPPPVVVVFEEEEVMPPCCCCCCCCPPPP
PPPPPPPPFEMMMMPPCCCCCCCCPPPPP
PPPFFVEEEMMMMMPPPPPPCCPPPPPPP
PPVVFEEEEMMMMPPPPPPPPPPPPPPPP
FFFFPPPFFFMMMMPPPTPPPPPPPPPPP
PPPFFFFFPPPFFFMMMMPPTTPPPPPPP
PPPPPPPPPPPFFFFPPPPTPPPPPPPPP
PPPFFFFFPPPFFFMMMMMMPPPPPPPPP
PPPFFVVVFFEEEEMMMMPPPPCCPPPPP
PPPPVVVVFEEEEMVMPPCCCCCCCPPPP
PPPPPPPPFEMMMMMPPCCCCCCCPPPPP
PPPFFVEEEMMMMMPPPPPPPCCPPPPPP
PPVVFEEEEMMMMPPPPPPPPPPPPPPPP
FFFFPPPFFFMMMMPPPTTPPPPPPPPPP
PPPFFFFFPPPFFFMMMMPPPTTPPPPPP
PPPPPPPPPPPFFFFPPPPTTPPPPPPPP
PPPPPPPPPPPPPPPPPPPPPPPPPPPPP