PPPPPPPPPPPPPPPPPPPPPPPPPPPPPP
PPPPPPPPPPPPPPEEEEPPPPPPPPPPPP
PPPPPPPPPPPFFEEMMFFFFPPPPPPPPP
PPPFFFFFPPPFFEEMMFFFFPPPPPPPPP
PPPFFFFFPPPFFFFMMMMMMPPPPPPPPP
PPPFFFFFPPPFFFMVVVVMMMPPPTPPPP
PPPFFFFFPPPFFFMMMMMMMPPPPPPPPP
PPPFFVVVFFEEEEMMMMPPPPPCCPPPPP
PPPPVVVVFEEEEMVMPPCCCCCCCCPPPP
PPPPPPPPFEMMMMMPPCCCCCCCCPPPPP
PPPFFVEEEMMMMMPPPPPPPCCPPPPPPP
PPVVFEEEEMMMMPPPPPPPPPPPPPPPPP
FFFFPPPFFFMMMMPPPTTPPPPPPPPPPP
PPPFFFFFPPPFFFMMMMPPPTTPPPPPPP
PPPPPPPPPPPFFFFPPPPTTPPPPPPPPP
PPPPPPPPPPPPPPPPPPPPPPPPPPPPPP
PPPPPPPPPPPPPPPPPPPPPPPPPPPPPP
PPPPPPPPPPPPPPEEEEPPPPPPPPPPPP
PPPPPPPPPPPFFEEMMFFFFPPPPPPPPP
PPPFFFFFPPPFFEEMMFFFFPPPPPPPPP
PPPFFFFFPPPFFFFMMMMMMPPPPPPPPP
PPPFFFFFPPPFFFMVVVVMMMPPPTPPPP
PPPFFFFFPPPFFFMMMMMMMPPPPPPPPP
PPPFFVVVFFEEEEMMMMPPPPPCCPPPPP
PPPPVVVVFEEEEMVMPPCCCCCCCCPPPP
PPPPPPPPFEMMMMMPPCCCCCCCCPPPPP
PPPFFVEEEMMMMMPPPPPPPCCPPPPPPP
PPVVFEEEEMMMMPPPPPPPPPPPPPPPPP
FFFFPPPFFFMMMMPPPTTPPPPPPPPPPP
PPPFFFFFPPPFFFMMMMPPPTTPPPPPPP
PPPPPPPPPPPFFFFPPPPTTPPPPPPPPP
PPPPPPPPPPPPPPPPPPPPPPPPPPPPPP