PPPPPPPPPPPPPPPPPPPPPPPPPPPPPPPPPPPPPPPPPPPPPPPPPPP
PPPPPPPPPPPPPPPPPPPPPPPPPPPPPPPPPPPPPPPPPPPPPPPPPPP
PPPPPPPPPPPPEEEEPPPPPPPPPPPPPPPPPPPPPPPPPPPPPPPPPPP
PPPPPPPPPFFEEMMFFFFPPPPPPPPPPPPPPPPPPPPPPPPPPPPPPPP
PPPFFFFFPFFEEMMFFFFPPPPPPPPPPPPPPPPPPPPPPPPPPPPPPPP
PPPFFFFFPPFFFMMMMMMPPPPPPPPPPPPPPPPPPPPPPPPPPPPPPPP
PPPFFFFFPPFFMVVVVMMMPPPTPPPPPPPPPPPPPPPPPPPPPPPPPPP
PPPFFFFFPPPFMMMMMMMPPPPPPPPPPPPPPPPPPPPPPPPPPPPPPPP
PPPFFVVVFFEEEMMMPPPPPCCPPPPPPPPPPPPPPPPPPPPPPPPPPPP
PPPPVVVVFEEEEVPPCCCCCCCCPPPPPPPPPPPPPPPPPPPPPPPPPPP
PPPPPPPPFEMMMMPCCCCCCCCPPPPPPPPPPPPPPPPPPPPPPPPPPPP
PPPFFVEEEMMMMMPPPPPCCPPPPPPPPPPPPPPPPPPPPPPPPPPPPPP
PPVVFEEEEMMMMPPPPPPPPPPPPPPPPPPPPPPPPPPPPPPPPPPPPPP
FFFFPPPFFFMMMMPPPTPPPPPPPPPPPPPPPPPPPPPPPPPPPPPPPPP
PPPFFFFFPPPFFFMMMMPTTPPPPPPPPPPPPPPPPPPPPPPPPPPPPPP
PPPPPPPPPPPFFFFPPPPTPPPPPPPPPPPPPPPPPPPPPPPPPPPPPPP
PPPFFFFFPPPFFFMMMMMMPPPPPPPPPPPPPPPPPPPPPPPPPPPPPPP
PPPFFVVVFFEEEEMMMMPPPPCPPPPPPPPPPPPPPPPPPPPPPPPPPPP
PPPPVVVVFEEEEMVMPPCCCCCCPPPPPPPPPPPPPPPPPPPPPPPPPPP
PPPPPPPPFEMMMMMPPCCCCCCCPPPPPPPPPPPPPPPPPPPPPPPPPPP
PPPFFVEEEMMMMMPPPPPPPCCPPPPPPPPPPPPPPPPPPPPPPPPPPPP
PPVVFEEEEMMMMPPPPPPPPPPPPPPPPPPPPPPPPPPPPPPPPPPPPPP
FFFFPPPFFFMMMMPPPTTPPPPPPPPPPPPPPPPPPPPPPPPPPPPPPPP
PPPFFFFFPPPFFFMMMMPPPTTPPPPPPPPPPPPPPPPPPPPPPPPPPPP
PPPPPPPPPPPFFFFPPPPTTPPPPPPPPPPPPPPPPPPPPPPPPPPPPPP
PPPPPPPPPPPPPPPPPPPPPPPPPPPPPPPPPPPPPPPPPPPPPPPPPPP
PPPPPPPPPPPPPPPPPPPPPPPPPPPPPPPPPPPPPPPPPPPPPPPPPPP
PPPPPPPPPPPPPPPPPPPPPPPPPPPPPPPPPPPPPPPPPPPPPPPPPPP
PPPPPPPPPPPPPPPPPPPPPPPPPPPPPPPPPPPPPPPPPPPPPPPPPPP
PPPPPPPPPPPPPPPPPPPPPPPPPPPPPPPPPPPPPPPPPPPPPPPPPPP
PPPPPPPPPPPPPPPPPPPPPPPPPPPPPPPPPPPPPPPPPPPPPPPPPPP
PPPPPPPPPPPPPPPPPPPPPPPPPPPPPPPPPPPPPPPPPPPPPPPPPPP
PPPPPPPPPPPPPPPPPPPPPPPPPPPPPPPPPPPPPPPPPPPPPPPPPPP
PPPPPPPPPPPPPPPPPPPPPPPPPPPPPPPPPPPPPPPPPPPPPPPPPPP
PPPPPPPPPPPPPPPPPPPPPPPPPPPPPPPPPPPPPPPPPPPPPPPPPPP
PPPPPPPPPPPPPPPPPPPPPPPPPPPPPPPPPPPPPPPPPPPPPPPPPPP
PPPPPPPPPPPPPPPPPPPPPPPPPPPPPPPPPPPPPPPPPPPPPPPPPPP
PPPPPPPPPPPPPPPPPPPPPPPPPPPPPPPPPPPPPPPPPPPPPPPPPPP
PPPPPPPPPPPPPPPPPPPPPPPPPPPPPPPPPPPPPPPPPPPPPPPPPPP
PPPPPPPPPPPPPPPPPPPPPPPPPPPPPPPPPPPPPPPPPPPPPPPPPPP
PPPPPPPPPPPPPPPPPPPPPPPPPPPPPPPPPPPPPPPPPPPPPPPPPPP
PPPPPPPPPPPPPPPPPPPPPPPPPPPPPPPPPPPPPPPPPPPPPPPPPPP
PPPPPPPPPPPPPPPPPPPPPPPPPPPPPPPPPPPPPPPPPPPPPPPPPPP
PPPPPPPPPPPPPPPPPPPPPPPPPPPPPPPPPPPPPPPPPPPPPPPPPPP
PPPPPPPPPPPPPPPPPPPPPPPPPPPPPPPPPPPPPPPPPPPPPPPPPPP