FFFFFFFVFFFFFFFJFPFJFJFFFFFJFFFFFFFFWHHM
FFFFFFFJFJFYFYFJJPJJJJFYFYFJFJFJFJFWWHHM
FFFFFFFJJJJYJYJYRRPJJJYJJJJJJDDDJJJWJJHH
WWWWFFFYJRRJYJYJRDPPJJYJJJJDDDDDJJJWJDHH
WWBWJJFJJRRDDDDDDYDPJJJJJPJJDJJJJDJDXJJJ
WWBWGJJGRRRYDYDDDJJJPPPPPJPPJDDDDJDJWJJJ
WWBBWWWWSDJJYDDDYDVJJJJJJGJJPJJJJJJWWJJJ
WWBWWJWGWWDWGDDDDRGFJJJGJGJPPJJJJJJWJJDJ
GGWSGGJGGGWGWWJDCRFFFJJJGPPPJJJDDDJJWWJJ
GWWWGGJFGJGGGGWGRJFJFFFJJPJJPJDDDDDJJWJJ
WWWWWFFFGJJGGGWWJGGGJJJJGPJGPGJGDWDDJWJG
WWWWWFFDFJJFJJXWWWWWJWBBPWWWPWWWWWWWWGGG
WWWWGDDDDJJDJDJDWWWWWWWWPWWWWWWWWWWGGGGJ
WGWGGDDFDDDDDJDGGGBWWWWWWWWWWWWGPGGGGGJJ
GGWWDJFFFDDGJJGJJGBBBGWGPPGGGGGGPPGPGJJJ
GGGWDJFJFJJGGFJJJJJJGGGGFGPGFFFGGGPGPJJG
GGGWDFJJJJGHJJFJFGGGGGGFFGPGFFGGGJGGPGGP
GGWDDFFFGGJHJJGJFJHGJFHFGGPGFGGGGGGGPPPG
DDWWFGFFJFHHJJJJFFGFFGFGGGPPGGGGGGGDGGJG
GGGWGGJJJFJFFFGGJGFFJGFGGGGPGGGJGVGGGJJG
HHGWGGGGJJFJFFGFGFFHFFHGGGGPGDDVVGGGGGGG
GGWWHRGGJGJFJJJFHHJJGGHFGGGPGPDVVVVGGGGG
HHHWHRGFGFFFFGFHHHJJGHFGFGGGPGPGVVVGGGGG
HHGWGGRGFHFGFJGHJHHHGBHGGGGGGGPPGGGGGGJJ
HMWMHHGGHHGGGGHGHWHWBHHHGGGGGGGGPPGGGJJJ
MMWWMMGHHMGGGGGWWEWWBBHHGHGGGGGGGGPGGJJJ
MMMMWMHHMMHMHHHHWWWBBHBMHHGHHGGGGGPPGGJJ
MMMWWMMMMMMMMMHWWOWHBHBMMHHHHHGGGGGGPPGG
MWWWMMMMMMMMMWMWOXHHHMMMHHHHHHHMGHGGGPGG
WWOOWMMMMMMOOWWMWMHMHMMMHMHMMMMMHHJJGPGG
WWOOWWMMMMMOOMMMMMMMMMMMMMMMMMMMMHHHHJPG
OOOOOOWEMOOOOMMMMMMMMMMMMMMMMMMMMHHHHJPG
WWWWWWWWWWWWMMMMMMMMMMMMMMMMMMMMMHHHJHPM