PPPPPPPPPPPPPPPPPPPPPPPPPPPPPPPPPP
PPPPPPPPPPPPPPPPPPPPPEEMPPPPPPPPPP
PPPPPPPPPFFMMPPFFPPPPPPPPPPPPPPPPP
PPPPPPPPPFFMMPPFFPPPPPPPPPPPPPPPPP
PPPPEEMPPPPPPPPPPPPFFMMVVPPPPPPPPP
PPEEVVEEPPPPPPPPPPPPPEEMPPPPPPPPPP
PPFFMMVVPPPPPPPPPPPPPEEMPPPPPPPPPP
PPFFMMVVPPPPPPPPPPPFFMMVVPPPPPPPPP
PPFFMMVVPPPPPPPPPPPFFMMVVPPPPPPPPP
PPPPPPPPPFFMMPPFFPPFFMMVVPPPPPPPPP
PPPPPPPPPFFMMPPFFPPFFMMVVPPPPPPPPP
PPPPEEMPPPPPPPPPPPPPPEEMPPPPPPPPPP
PPEEVVEEPPPPPPPPPPPFFMMVVPPPPPPPPP
PPFFMMVVPPPPPPPPPPPFFMMVVPPPPPPPPP
PPFFMMVVPPPPPPPPPPPFFMMVVPPPPPPPPP
PPPPPPPPPPPPPPPPPPPPPPPPPPPPPPPPPP
