PPPPPPPPPP
PPFFMMPPFF
PPFFMMPPFF
PPPPEEMPPP
PPEEVVEEPP
PPFFMMVVPP
PPFFMMVVPP
PPPPPPPPPP
