PPPPPPPPPPPPPPPPPPPPPPPPPPPPPPPPPP
PPPPPPPPPPPPPPEEEEPPPPPPPPPPPPPPPP
PPPPPPPPPPPFFEEMMFFFFPPPPPPPPPPPPP
PPPFFFFFPPPFFEEMMFFFFPPPPPPPPPPPPP
PPPFFFFFPPPFFFFMMMMMMPPPPPPPPPPPPP
PPPFFFFFPPPFFFMVVVVMMMPPPTTPPPPPPP
PPPFFFFFPPPFFFMMMMMMMPPPTTPPPPPPPP
PPPFFVVVFFEEEEMMMMVVMPPPPPPCCPPPPP
PPPPVVVVFEEEEMMMMMVMPPCCCCCCCCPPPP
PPPPPPPPFEEEEMMMMMMPPCCCCCCCCPPPPP
PPPFFVVVFEEEEMMMMMPPPPPPPCCPPPPPPP
PPPFFVVVFEEEEMMMMPPPPPPPPPPPPPPPPP
PPPFFFFFPPPFFFMMMMPPPTTPPPPPPPPPPP
PPPFFFFFPPPFFFMMMMPPPTTPPPPPPPPPPP
PPPPPPPPPPPFFFFPPPPTTPPPPPPPPPPPPP
PPPPPPPPPPPPPPPPPPPPPPPPPPPPPPPPPP
